nivel 3;
9,9
#########
#   #   #
# $ #   #
#   # $ #
# # # # #
# @ . . #
# # # # #
#       #
#########
