nivel 1;
8,8;
########
#@     #
#   .  #
# . $ .#
# . $ .#
#      #
#      #
########