nivel 5;
13,13
#############
#     #     #
#  $  #  $  #
#  #  #  #  #
#  #  #  #  #
#     #  .  #
#  $  #  #  #
#     #  @  #
#  #  #  #  #
#  .  #  $  #
#           #
# ..        #
#############
