nivel 2;
8,8;
########
#@   ###
#   $#.#
# $  # #
#    # #
#      #
# .    #
########