nivel 4;
13,13
#############
#     #   . #
#           #
#     #     #
#  $  #  $  #
#     #     #
#     #     #
#           #
#  @  #     #
# .   #  $  #
#     #     #
#  .  #     #
#############
