nivel 1;
8,8;
########
#@BBBB.#
#BBBBBB#
#B.B$B.#
#B.B$B.#
#BBBBBB#
#BBBBBB#
########