nivel 1;
8,8;
B#######
B#BBBBB#
B#B.$.B#
B#BBBBB#
##B$@$B#
##BBBBB#
#BB.$.B#
#BBBBBB#
########