Nivel 3;
10,7;
B####BBBBB
B#BB####BB
B#BBBBB##B
##B##BBB#B
#.B.#B@$##
#BBB#B$$B#
#BB.#BBBB#
##########